|-----------------------------------------------------------------------------|
|                                                                             |
| |-------------------|     |--------------------------|                      |
| |...................|     |..........................|--------------------| |
| |...................+#####+...............................................| |
| |...................|     |...............................................| |
| |...................|     |...............................................| |
| |...................|     |---------+-----|...............................| |
| |...................|               #     |---------------|...............| |
| |...................|        ########                     |...............| |
| |...................|        #                            |...............| |
| |----------+--------|        #                            |...............| |
|            #            |----+------|                     |...............| |
|            #            |...........|                     |-----+---------| |
| |----------+-----|      |...........|   |-----------|           #           |
| |................|      |...........|   |...........+############           |
| |................|      |...........|---|...........|     #     #         | |
| |................+######+...........................|     #   |-+---------| |
| |................|      |...........................|     #   |...........| |
| |................|      |...........................|     #   |...........| |
| |................|      |...........................|     #   |...........| |
| |................|      |-------------------+-------|     #   |...........| |
| |----------------|                          #             #   |...........| |
|                           #################################   |...........| |
|                           #                                   |...........| |
|         |-----------------+--------|                    |-----|...........| |
|   |-----|..........................|        |-----------|.................| |
|   |................................|        |.............................| |
|   |................................|        |.............................| |
|   |................................|        |.......................|-----| |
|   |................................+########+.......................|       |
|   |................................|        |-----------------------|       |
|   |--------------------------------|                                        |
|                                                                             |
|-----------------------------------------------------------------------------|