|-----------------------------------------------------------------------------|
|                                                                             |
| |--------------------|                    |-------------------------------| |
| |....................|                    |...............................| |
| |....................|              |-----|...............................| |
| |....................|              |.....................................| |
| |....................+##############+.....................................| |
| |...........|--------|       #      |.....................................| |
| |...........|                #      |.....................................| |
| |...........|                #      |-------------|.......................| |
| |...........|                #                    |.......................| |
| |----------+|                #                    |.......................| |
|            #            |----+------|             |.......................| |
|            #            |...........|             |-------------+---------| |
| |----------+------------|...........|---|                       #           |
| |.......................................|   #####################           |
| |.......................................|   #                   #           |
| |................|------|...............|   #     |-------------+---------| |
| |................|      |...............|   #     |.......................| |
| |................|      |...............|   #     |.......................| |
| |................+######+...............+####     |.......................| |
| |................|      |---------------|   #     |-----|.................| |
| |-----------+----|                          #           |.................| |
|             #                               #           |.................| |
|             #                    #######################+.................| |
|         |---+-----------|        #                      |.................| |
|         |...............|        #                      |.................| |
|         |...............|--------+--------|        |----|.........|-------| |
|   |-----|.................................|        |..............|         |
|   |.......................................|        |..............|         |
|   |.......................................+########+..............|         |
|   |.......................................|        |--------------|         |
|   |---------------------------------------|                                 |
|                                                                             |
|-----------------------------------------------------------------------------|