|-----------------------------------------------------------------------------|
|                                                                             |
| |--------------------|              |-------------------------------|       |
| |....................|              |...............................|       |
| |....................|              |...............................|       |
| |....................|              |...............................|--|    |
| |....................+##############+..................................|--| |
| |----------+---------|       #      |.....................................| |
|            #                 #      |.....................................| |
|            #                 #      |............|--------|...............| |
|            #                 #      |............|        |...............| |
|            ###################      |............|  ######+...............| |
|            #                 #      |............|  #     |--------+------| |
|            #                 #      |----+-------|  #              #        |
| |----------+----------|      #           #          #              #        |
| |.....................|      #           #          #              #        |
| |.....................|      ########################         |----+------| |
| |.....................|      #           #                    |...........| |
| |.....................|      #    |------+----------|         |...........| |
| |.....................|   ####    |.................|     |----...........| |
| |................-----|   #       |.................+#####+...............| |
| |................|        #    |--...............---|     |...............| |
| |................|        #    |.................|        |...............| |
| |................|        #    |.................|        |...............| |
| |--+----|........|        #    |.................|        |-+-------+-----| |
|    #    |........|        #    |.................|          +       +       |
|    #    |........|        #    |.................|          +       +       |
|    #    |........|        #    |.................|----------+-------+--|    |
|   |+----|........+#############+.......................................|    |
|   |..............|             |.......................................|    |
|   |..............|             |.......................................|    |
|   |..............|             |.......................................|    |
|   |--------------|             |---------------------------------------|    |
|                                                                             |
|-----------------------------------------------------------------------------|